Doll	Chair
Toy 	Mask
Red 	Brother
Honey	Lunch
Mother	Table
Jug	    Jelly
Eight 	Piece
Friend 	Camel
Family 	Feast
Tree	Whale
Pony	Jump
Again	Flower
Tree	Nut
Yellow	Simple
Drawing	Follow
Birthday	Boat
Apple	Animal
Bell	Bounce
Crown	Castle
Drum	Dust
Elephant	Ear
Fish	Foam
Glass	Guest
Hut	    Hand
Ice	    Ink
Jacket	Jam
Kite	Kind
Long	Lamp
Master	Mat
Nest	Night
Orange	Owl
Parrot	Pencil
Queen	Queue
Rose	Rest
Sweet	Sleep
Train	Tin
Uncle	Unable
Van	    Vest
Water	Weep
Yak	    Zip